Nivel 2
5 9
+++++++++
+.#.*...+
+W......+
+..#..*.+
+++++++++
