Nivel 8
7 8
++++++++
+++....+
+++....+
+...+*++
+..##*++
++...W++
++++++++