Nivel 6
7 8
++++++++
++....++
+..++.++
+.#*#*.+
++.+...+
++.W.+++
++++++++