Nivel 7
8 8
++++++++
+++..+++
+++#*W.+
+...+..+
+..#*.++
+..+..++
++++..++
++++++++